30
AAAAAAAAAAAAAAAHAAAAAAAAAAAAAA
ARRRRRRRRRRRRRRRRRRRRRRRRRRRRA
ARRRRRRRRRRRRRRRRRRRRRRRRRRRRA
ARRRRRRRRRRRRRRRRRRRRRRRRRRRRA
ARRRRRRRRRRRRRRRRRRRRRRRRRRRRA
ARRRRRRRRRRRRRRRRRRRRRRRRRRRRA
ARRRRRRRRRRRRRRRRRRRRRRRRRRRRA
ARRRRRRRRRRRRRRRRRRRRRRRRRRRRA
ARRRRRRRRRRRRRRRRRRRRRRRRRRRRA
HRRRRRRRRRRRRRRRRRRRRRRRRRRRRH
ARRRRRRRRRRRRRRRRRRRRRRRRRRRRA
ARRRRRRRRRRRRRRRRRRRRRRRRRRRRA
ARRRRRRRRRRRRRRRRRRRRRRRRRRRRA
ARRRRRRRRRRRRRRRRRRRRRRRRRRRRA
ARRRRRRRRRRRRRRRRRRRRRRRRRRRRA
ARRRRRRRRRRRRRRRRRRRRRRRRRRRRA
ARRRRRRRRRRRRRRRRRRRRRRRRRRRRA
ARRRRRRRRRRRRRRRRRRRRRRRRRRRRA
ARRRRRRRRRRRRRRRRRRRRRRRRRRRRA
AAAAAAAAAAAAAAAHAAAAAAAAAAAAAA