30
AAAAAAAAAAAAAAPAAAAAAAAAAAAAAA
AHHHHHHHHHHHHHPHHHHHHHHHHHHHHA
AHHHHHHHHHHHHHPHHHHHHHHHHHHHHA
AHHHHHHHHHHHHHPHHHHHHHHHHHHHHA
AHHHHHHHHHHHHHPHHHHHHHHHHHHHHA
AHHHHHHHHHHHHHPHHHHHHHHHHHHHHA
AHHHHHCHHHHHHHPHHHHHHHHCHHHHHA
AHHHHHCHHHHHHHPHHHHHHHHCHHHHHA
AHHHHHCHHHHHHHPHHHHHHHHCHHHHHA
PPPPPPPPPPPPPPPPPPPPPPPPPPPPPP
AHHHHHCHHHHHHHPHHHHHHHHCHHHHHA
AHHHHHCHHHHHHHPHHHHHHHHCHHHHHA
AHHHHHCHHHHHHHPHHHHHHHHCHHHHHA
AHHHHHHHHHHHHHPHHHHHHHHHHHHHHA
AHHHHHHHHHHHHHPHHHHHHHHHHHHHHA
AHHHHHHHHHHHHHPHHHHHHHHHHHHHHA
AHHHHHHHHHHHHHPHHHHHHHHHHHHHHA
AHHHHHHHHHHHHHPHHHHHHHHHHHHHHA
AHHHHHHHHHHHHHPHHHHHHHHHHHHHHA
AAAAAAAAAAAAAAPAAAAAAAAAAAAAAA


