AAAAAAAAAAAAAAHAAAAAAAAAAAAAAA
AHHHHHHHHHHHHHHHHHHHHHHHHHHHHA
AHHHHHHHHHHHHHHHHHHHHHHHHHHHHA
AHHHHHHHHHHHHHHHHHHHHHHHHHHHHA
AHHHHHHHHHHHHHHHHHHHHHHHHHHHHA
AHHHHHHHHHHHHHHHHHHHHHHHHHHHHA
AHHHHHHHHHHHHHHHHHHHHHHHHHHHHA
AHHHHHHHHHHHHHHHHHHHHHHHHHHHHA
AHHHHHHHHHHHHHHHHHHHHHHHHHHHHA
HHHHHHHHHHHHHHHHHHHHHHHHHHHHHH
AHHHHHHHHHHHHHHHHHHHHHHHHHHHHA
AHHHHHHHHHHHHHHHHHHHHHHHHHHHHA
AHHHHHHHHHHHHHHHHHHHHHHHHHHHHA
AHHHHHHHHHHHHHHHHHHHHHHHHHHHHA
AHHHHHHHHHHHHHHHHHHHHHHHHHHHHA
AHHHHHHHHHHHHHHHHHHHHHHHHHHHHA
AHHHHHHHHHHHHHHHHHHHHHHHHHHHHA
AHHHHHHHHHHHHHHHHHHHHHHHHHHHHA
AHHHHHHHHHHHHHHHHHHHHHHHHHHHHA
AAAAAAAAAAAAAAHAAAAAAAAAAAAAAA


