30
AAAAAAAAAAAAAAPAAAAAAAAAAAAAAA
AHHHHHHHHHHHHHPHHHHHHHHHHHHHHA
AHHHHHHHHHHHHHPHHHHHHHHHHHHHHA
AHHHHHHHHHHHHHPHHHHHHHHHHHHHHA
AHHHHHHHHHHHHHPHHHHHHHHHHHHHHA
AHHHHHHHHHHHHHPHHHHHHHHHHHHHHA
AHHHHHCHHHHHHHPHHHHHHHHCHHHHHA
AHHHHHCHHHHHHHPHHHHHHHHCHHHHHA
AHHHHHCHHHHHHHPHHHHHHHHCHHHHHA
PPPPPPPPPPPPPPPPPPPPPPPPPPPPPP
AHHHHHHHHHHHHHPHHHHHHHHHHHHHHA
AHHHHHHHHHHHHHPHHHHHHHHHHHHHHA
AHHHHHHHHHHHHHPHHHHHHHHHHHHHHA
AHHHHHHHHHHHHHPHHHHHHHHHHHHHHA
AHHHHHHHHHHHHHPHHHHHHHHHHHHHHA
AHHHHHCHHHHHHHPHHHHHHHCHHHHHHA
AHHHHHCHHHHHHHPHHHHHHHCHHHHHHA
AHHHHHCCCCCCCCPCCCCCCCCHHHHHHA
AHHHHHHHHHHHHHPHHHHHHHHHHHHHHA
AAAAAAAAAAAAAAPAAAAAAAAAAAAAAA



