30
AAAAAAAAAAAAAAAPAAAAAAAAAAAAAA
AHHHHHHHHHHHHHHPHHHHHHHHHHHHHA
AHHHHHHHHHHHHHHPHHHHHHHHHHHHHA
AHHHHHHHHHHHHHHPHHHHHHHHHHHHHA
AHHHHHHHHHHHHHHPHHHHHHHHHHHHHA
AHHHHHHHHHHHHHHPHHHHHHHHHHHHHA
AHHHHHCHHHHHHHHPHHHHHHHCHHHHHA
AHHHHHCHHHHHHHHPHHHHHHHCHHHHHA
AHHHHHCHHHHHHHHPHHHHHHHCHHHHHA
PPPPPPPPPPPPPPPPPPPPPPPPPPPPPP
AHHHHHCHHHHHHHHPHHHHHHHCHHHHHA
AHHHHHCHHHHHHHHPHHHHHHHCHHHHHA
AHHHHHCHHHHHHHHPHHHHHHHCHHHHHA
AHHHHHHHHHHHHHHPHHHHHHHHHHHHHA
AHHHHHHHHHHHHHHPHHHHHHHHHHHHHA
AHHHHHHHHHHHHHHPHHHHHHHHHHHHHA
AHHHHHHHHHHHHHHPHHHHHHHHHHHHHA
AHHHHHHHHHHHHHHPHHHHHHHHHHHHHA
AHHHHHHHHHHHHHHPHHHHHHHHHHHHHA
AAAAAAAAAAAAAAAPAAAAAAAAAAAAAA



