18
WWWWWWWWWWWWWWWWWW
WSSSSSSSSSSSSSSSSW
WSSSSSSSSSSSSSSSSW
WSSSSSSSSSSSSSSSSW
WSSSSSSSSSSSSSSSSW
WSSSSSSSSSSSSSSSSW
WSSSSSSSSSSSSSSSSW
WSSSSSSSSSSSSSSSSW
WSSSSSSSSSSSSSSSSW
WSSSSSSSSSSSSSSSSW
WSSSSSSSSSSSSSSSSW
WWWWWWWWWDWWWWWWWW

