15
WWWWWWWWWWWWWWW
WSWSSSSWSSSSSSW
WSWSSSSWSSSSSSW
WSWSSSSWSSSSSSW
WSWWSWWWSSSSSSW
WSSSSSSSSSSSSSW
WSSSSSSSSSSSSSW
WSSSSSSSSSSSSSW
WSSSSSSSSSSSSSW
WWWWWWWDWWWWWWW
adult 10 4
toilet 1 1
kitchen 11 1