21
WWWWWWWWWWWWWWWWWWWWW
WSSSSSSSSSSSSSSSSSSSW
WSSSSSSSSSSSSSSSSSSSW
WSSSSSSSSSSSSSSSSSSSW
WSSSSSSSSSSSSSSSSSSSW
WSSSSSSSSSSSSSSSSSSSW
WSSSSSSSSSSSSSSSSSSSW
WSSSSSSSSSSSSSSSSSSSW
WSSSSSSSSSSSSSSSSSSSW
WSSSSSSSSSSSSSSSSSSSW
WSSSSSSSSSSSSSSSSSSSW
WSSSSSSSSSSSSSSSSSSSW
WSSSSSSSSSSSSSSSSSSSW
WWWWWWWWWWDWWWWWWWWWW

