15
WWWWWWWWWWWWWWW
WSSSSSSWSSSSSSW
WSSSSSSWSSSSSSW
WSSSSSSWSSSSSSW
WWWWSWWWSSSSSSW
WSSWSSSSSSSSSSW
WSSSSSSSSSSSSSW
WSSWSSSSSSSSSSW
WSSWSSSSSSSSSSW
WWWWWWWDWWWWWWW
adult 10 4
toilet 1 5
kitchen 11 1
bath 2 7