15
WWWWWWWWWWWWWWW
WSWSSSSSSSSSSSW
WSWSSSSSSSSSSSW
WWWSSSSSSSSSSSW
WSSSSSSSSSSSSSW
WSSSSSSSSSSSSSW
WSSSSSSSSSSSSSW
WSSSSSSSSSSSSSW
WSSSSSSSSSSSSSW
WWWWWWWDWWWWWWW
