18
WWWWWWWWWWWWWWWWWW
WSWSSSSWSSSSSSSSSW
WSWSSSSWSSSSSSSSSW
WSWSSSSWSSSSSSSSSW
WSWWSWWWSSSSSSSSSW
WSSSSSSSSSSSSSSSSW
WSSSSSSSSSSSSSSSSW
WSSSSSSSSSSSSSSSSW
WSSSSSSSSSSSSSSSSW
WSSSSSSSSSSSSSSSSW
WSSSSSSSSSSSSSSSSW
WWWWWWWWWDWWWWWWWW