30
AAAAAAAAAAAAAAHAAAAAAAAAAAAAAA
ARRRRRRRRRRRRRRRRRRRRRRRRRRRRA
ARRRRRRRRRRRRRRRRRRRRRRRRRRRRA
ARRRRRRRRRRRRRRRRRRRRRRRRRRRRA
ARRRRRRRRRRRRRRRRRRRRRRRRRRRRA
ARRRRRRRRRRRRRRRRRRRRRRRRRRRRA
ARRRRRRRRRRRRRRRRRRRRRRRRRRRRA
ARRRRRRRRRRRRRRRRRRRRRRRRRRRRA
ARRRRRRRRRRRRRRRRRRRRRRRRRRRRA
HRRRRRRRRRRRRRRRRRRRRRRRRRRRRH
ARRRRRRRRRRRRRRRRRRRRRRRRRRRRA
ARRRRRRRRRRRRRRRRRRRRRRRRRRRRA
ARRRRRRRRRRRRRRRRRRRRRRRRRRRRA
ARRRRRRRRRRRRRRRRRRRRRRRRRRRRA
ARRRRRRRRRRRRRRRRRRRRRRRRRRRRA
ARRRRRRRRRRRRRRRRRRRRRRRRRRRRA
ARRRRRRRRRRRRRRRRRRRRRRRRRRRRA
ARRRRRRRRRRRRRRRRRRRRRRRRRRRRA
ARRRRRRRRRRRRRRRRRRRRRRRRRRRRA
AAAAAAAAAAAAAAHAAAAAAAAAAAAAAA